0000000000000000
0000000000000000
0000000000000000
0000000000000000
0001111001111100
0011001001000100
0010301111300100
0010032222030100
0011000010401100
0001111111111000
0000000000000000
0000000000000000
0000000000000000
0000000000000000
