0000000000000000
0000000000000000
0000000000000000
0000011100000000
0000012100000000
0000010111100000
0001113032100000
0001203411100000
0001111310000000
0000001210000000
0000001110000000
0000000000000000
0000000000000000
0000000000000000
