0000000000000000
0000000000000000
0000000000000000
0000111111110000
0000110000110000
0000103033010000
0000122222210000
0000103303010000
0000111041110000
0000001111000000
0000000000000000
0000000000000000
0000000000000000
0000000000000000
