0000000000000000
0000000000000000
0000001111100000
0000111004100000
0000100320110000
0000100232010000
0000111053010000
0000001000110000
0000001111100000
0000000000000000
0000000000000000
0000000000000000
0000000000000000
0000000000000000
