0000000000000000
0000000000000000
0000000000000000
0001111111100000
0001001000100000
0001032230100000
0001432501100000
0001032230100000
0001001000100000
0001111111100000
0000000000000000
0000000000000000
0000000000000000
0000000000000000
