0000000000000000
0000011111100000
0000010222100000
0011112222100000
0010011130111000
0010303003301000
0010030300001000
0014001110001000
0011111001111000
0000000000000000
0000000000000000
0000000000000000
0000000000000000
0000000000000000
