0000000000000000
0000000000000000
0000000000000000
0000001111100000
0000111000111100
0000100030300100
0000103000304100
0000111331111100
0000001002210000
0000001222210000
0000001111110000
0000000000000000
0000000000000000
0000000000000000
