0000000000000000
0000000000000000
0000111111100000
0000122322100000
0000122122100000
0000103330100000
0000100300100000
0000103330100000
0000100140100000
0000111111100000
0000000000000000
0000000000000000
0000000000000000
0000000000000000
