0000000000000000
0011111111111100
0010001100111100
0010300000000100
0011311101100100
0010011050101100
0010322222201000
0110111020101000
0100000311131000
0100010000341000
0111113101111000
0000010001000000
0000011111000000
0000000000000000
