0000000000000000
0000000000000000
0011111111000000
0010000001000000
0010133001000000
0010222101000000
0011222301100000
0001011030100000
0001300300100000
0001001400100000
0001111111100000
0000000000000000
0000000000000000
0000000000000000
