0000000000000000
0000000000000000
0000000000000000
0000011111111110
0001110002000010
0001000113110010
0001043202023110
0001103113110100
0000100002000100
0000111111111100
0000000000000000
0000000000000000
0000000000000000
0000000000000000
