0111100000011110
0122100000012210
0122111111112210
0103022222232310
0130303030303010
0103030343030310
0130303030303010
0103030303030310
0132322222203010
0122111111112210
0122100000012210
0111100000011110
0000000000000000
0000000000000000
