0000000000000000
0000111111000000
0011100001110000
0010001300011100
0010003000330100
0010330130000100
0011000300030100
1111110131111100
1224013001000000
1212200311000000
1222231010000000
1222200010000000
1111111110000000
0000000000000000
