0000000000000000
0000000000000000
0000000000000000
0000011111100000
0000012022100000
0000012032100000
0000111003110000
0000103003010000
0000101311010000
0000100040010000
0000111111110000
0000000000000000
0000000000000000
0000000000000000
