0111111111111000
0100000102221000
0100110100221000
0100100000221000
0101130100221000
0100300100221000
0103300111111000
0100330300110000
0101003330010000
0100011034110000
0100000000100000
0111111111100000
0000000000000000
0000000000000000
