0000000000000000
0000000000000000
0000111110000000
0000140111000000
0000103001000000
0001110101100000
0001210100100000
0001230010100000
0001200030100000
0001111111100000
0000000000000000
0000000000000000
0000000000000000
0000000000000000
